SO textures/1.png
NO textures/3.png
WE textures/4.png
EA textures/5.png

F 255,200,71
C 0,255,255

1111
10W1
1001
1111

